列朝小傳 - 〔清〕錢謙益
　乾集
　　太祖高皇帝 - 朱元璋
　　建文惠宗讓皇帝 - 朱允炆
　　太宗文皇帝 - 朱棣
　　仁宗昭皇帝 - 朱高熾
　　宣宗章皇帝 - 朱瞻基
　　孝宗敬皇帝 - 朱祐樘
　　武宗毅皇帝 - 朱厚照
　　興獻王睿宗獻皇帝 - 朱祐杬
　　世宗肅皇帝 - 朱厚熜
　　神宗顯皇帝 - 朱翊鈞
　　蜀獻王 - 朱椿
　　寧獻王 - 朱權
　　漢王高煦 - 朱高煦
　　周憲王 - 朱有燉（附見 周藩王宮辭）
　　秦康王 - 朱志邅
　　秦簡王 - 朱成泳
　　蜀成王 - 朱讓栩
　　肅靖王 - 朱眞淤
　　瀋安王 - 朱銓稣
　　瀋憲王 - 朱胤栘
　　德平榮順王 - 朱胤梗
　　瀋宣王 - 朱恬烄
　　鎮康王 - 朱恬焯
　　安慶王 - 朱恬爖
　　瀋定王 - 朱珵堯
　　保定王 - 朱珵坦
　　趙康王 - 朱厚煜
　　益荘王 - 朱厚燁
　甲前集
　　劉誠意基
　　席帽山人王逢（附見 王技 王椿）
　　九靈山人戴良
　　王參軍冕
　　李翰林祁
　　丁高士鶴年（附見 吉雅謨 愛理沙 吳惟善）
　　鐵崖先生楊維楨
　　張員外昱
　　鐵崖先生楊維楨（附見 张簡 潘純 黄公望 曹睿 陳褧 楊椿 顧晉 顧元臣 顧佐 宋元禧 馬琬 張出 張希賢 葉廣居 周南 沈性 廠恭 強珇 士女曹妙清 士女張炒净 薛氏蕳英、蕙英）






